60 60 60 60 60 60 60 60 60 60 60 60 60 60 60 60 60 60 60 60 60 60 60 60 60 60 60 60 60 60 60 60 60 60 60 60 60 60 60 60 60 60 60 60 60 60 60 60 60 60 60
60 60 60 60 60 60 60 60 60 60 60 60 60 60 60 60 60 60 60 60 60 60 60 60 60 60 60 60 60 60 60 60 60 60 60 60 60 60 60 60 60 60 60 60 60 60 60 60 60 60 60
60 60 47 46 46 46 46 46 46 46 46 46 46 46 46 46 46 46 46 46 46 46 46 46 46 46 46 46 46 46 46 46 46 46 46 46 46 45 60 60 47 46 46 46 46 46 46 46 45 60 60
60 60 48 40 50 50 50 50 50 50 50 50 50 50 50 50 50 50 50 50 50 50 50 50 50 50 50 50 50 50 50 50 50 50 50 50 50 50 70 71 50 50 50 50 50 50 50 50 50 70 60
60 60 48 40 15 15 15 10 15 10 10 10 10 10 11 10 10 10 10 10 10 10 10 17 10 16 10 15 19 10 17 10 19 93 93 15 15 16 69 65 15 15 16 10 110 10 17 15 16 69 60
60 60 48 40 16 16 16 10 10 15 10 10 10 21 10 11 15 10 92 20 10 10 10 93 15 10 16 16 18 10 18 10 92 10 10 15 10 10 69 65 15 15 15 10 10 10 18 18 17 69 60
60 60 48 40 17 17 17 16 16 10 15 10 10 21 10 11 11 92 10 20 10 10 17 10 15 84 87 82 82 82 82 82 82 82 82 82 82 82 82 82 82 82 82 82 82 82 82 82 89 82 82
60 60 48 40 18 18 18 10 16 17 10 10 10 21 10 92 10 10 10 20 93 10 19 93 16 86 85 83 83 83 83 83 83 83 83 83 83 83 83 83 83 83 83 83 83 83 83 83 88 83 83
60 60 48 40 19 19 19 10 10 16 10 16 10 21 10 10 10 93 10 20 10 93 10 10 16 80 81 10 19 10 18 10 16 17 10 15 15 15 69 65 16 10 10 10 10 10 16 10 10 69 60
60 60 48 40 10 15 10 93 10 10 16 10 21 20 20 29 10 10 92 20 10 10 16 10 17 80 81 19 10 18 10 15 10 16 16 10 10 10 69 65 15 10 10 10 10 17 17 19 10 69 60
60 60 48 40 10 15 15 10 93 17 10 15 10 10 10 20 10 17 17 20 10 16 16 21 16 80 81 15 10 10 10 10 10 10 10 10 10 10 69 65 16 19 19 10 10 10 18 10 10 69 60
60 60 48 40 16 16 16 10 18 10 92 10 10 15 10 20 15 16 10 20 17 10 15 21 17 80 81 15 10 10 10 10 10 10 10 10 10 10 69 73 49 49 49 49 49 49 49 49 49 72 60
60 60 48 40 10 92 93 10 18 18 10 15 10 10 18 31 21 21 21 20 20 21 21 27 16 80 81 10 19 10 10 11 11 10 10 10 10 10 69 60 41 42 42 42 42 42 42 42 43 60 60
60 60 48 40 16 92 10 10 11 16 11 10 10 16 18 21 10 10 18 10 21 10 10 10 17 80 81 10 19 10 10 11 11 10 10 10 10 10 62 63 63 63 63 63 63 63 63 63 52 60 60
60 60 48 40 10 17 93 10 10 17 10 11 10 15 16 20 11 10 10 17 20 16 10 92 18 80 81 10 10 10 10 10 10 10 10 10 10 10 10 10 10 10 10 10 10 10 10 40 44 60 60
60 60 48 40 16 10 92 92 11 15 15 10 18 16 10 20 10 11 19 10 16 10 16 10 17 80 81 10 10 10 10 10 10 10 10 10 10 10 10 10 10 10 10 10 10 10 10 40 44 60 60
60 60 48 40 10 16 17 17 10 10 10 10 10 17 18 33 11 10 11 17 17 10 10 10 17 80 81 18 10 10 10 10 10 10 10 10 10 10 10 10 10 10 10 10 10 10 10 40 44 60 60
60 60 48 40 10 93 10 17 11 10 15 10 18 17 18 26 21 21 20 20 30 29 16 10 16 80 81 16 10 10 10 10 10 10 10 10 10 10 10 10 10 10 10 18 10 10 10 40 44 60 60
60 60 48 40 10 10 18 10 10 17 10 16 10 10 10 16 10 17 10 10 25 24 10 10 16 80 81 92 17 10 10 10 10 10 10 10 10 19 10 10 10 10 10 10 10 10 10 40 44 60 60
60 60 48 40 17 16 10 10 17 10 18 10 10 10 10 18 10 16 10 10 25 24 15 15 19 80 81 10 17 10 10 10 10 10 10 10 10 19 10 10 10 10 10 10 18 10 10 40 44 60 60
60 60 48 40 10 16 10 10 10 10 10 16 10 10 16 10 19 10 10 10 25 24 10 10 19 80 81 10 17 10 10 10 10 10 10 10 10 10 19 10 10 10 10 10 18 10 10 40 44 60 60
60 60 48 40 10 10 10 10 10 10 16 10 16 17 10 16 10 10 10 10 25 24 15 10 19 80 81 10 10 10 10 19 10 10 68 67 67 67 67 67 66 10 10 16 18 10 10 40 44 60 60
60 60 48 40 15 10 17 10 10 16 10 17 10 10 10 10 18 17 15 15 25 24 10 17 19 80 81 10 10 10 10 19 10 10 69 60 60 60 60 60 65 10 10 10 10 10 10 40 44 60 60
60 60 48 40 10 15 10 15 18 28 23 23 23 23 23 29 10 10 17 16 25 24 16 10 19 80 81 10 10 10 10 10 10 10 69 60 60 60 61 60 65 10 10 10 10 10 10 40 44 60 60
60 60 48 40 10 10 15 10 18 25 21 21 20 20 20 33 23 23 23 23 32 33 23 23 23 80 81 10 10 10 10 10 10 10 69 60 61 60 61 60 65 10 10 10 10 10 10 40 44 60 60
60 60 48 40 10 15 10 15 18 25 21 21 21 21 20 20 20 21 21 21 20 20 20 20 21 80 81 10 10 10 10 10 10 10 69 61 60 60 60 60 65 10 10 16 17 10 10 40 44 60 60
60 60 48 40 28 23 23 23 23 32 20 21 21 21 20 31 22 22 22 22 22 22 22 22 22 80 81 10 18 10 10 10 10 10 62 63 63 63 63 63 64 10 10 16 10 10 10 40 44 60 60
60 60 48 40 25 21 21 20 20 20 20 21 21 20 20 24 15 19 19 19 18 17 10 15 15 80 81 10 10 10 10 10 10 10 10 10 10 10 10 16 10 10 16 10 10 10 10 40 44 60 60
60 60 48 40 25 20 20 20 20 20 21 21 21 21 20 24 15 19 19 18 17 16 10 15 15 80 81 10 10 10 10 10 10 10 10 16 10 10 16 16 10 10 10 10 17 10 10 40 44 60 60
60 60 48 40 25 20 21 20 20 20 20 20 20 21 21 24 16 18 19 17 17 15 11 15 15 80 81 17 17 17 10 16 19 18 17 15 10 10 10 10 10 10 10 10 10 10 10 40 44 60 60
60 60 48 40 25 20 20 21 20 21 20 20 20 20 21 24 16 17 15 10 10 11 11 17 18 80 81 10 17 17 17 10 16 19 18 17 15 10 17 17 17 10 16 19 18 17 15 40 44 60 60
60 60 48 40 25 20 21 20 20 20 21 20 20 20 21 24 16 16 15 11 16 19 19 17 16 80 81 10 17 17 17 10 16 19 18 17 15 10 10 18 10 10 10 10 10 10 10 40 44 60 60
60 60 48 40 25 20 20 20 20 20 21 21 20 20 20 24 17 17 17 10 16 19 18 17 15 80 81 10 10 18 18 10 10 16 16 10 10 10 18 10 10 10 10 10 10 10 10 40 44 60 60
60 60 48 40 25 20 20 20 20 21 21 21 21 20 20 24 18 18 17 11 16 16 16 17 17 80 81 10 10 10 10 10 10 10 10 10 10 10 10 10 10 10 18 10 10 10 10 40 44 60 60
60 60 48 40 26 30 20 31 22 22 22 22 22 22 22 27 17 16 17 10 11 11 11 10 16 80 81 10 10 10 10 10 16 10 10 10 10 10 18 18 10 10 10 10 17 18 10 40 44 60 60
60 60 48 40 16 25 21 24 15 15 10 17 10 15 16 16 17 15 17 18 18 19 18 10 16 80 81 10 10 15 10 10 10 10 10 10 10 10 10 10 10 10 10 10 10 10 10 40 44 60 60
60 60 48 40 15 25 20 24 15 15 10 10 15 15 18 19 11 11 10 11 11 10 17 11 16 80 81 10 10 15 10 10 16 10 10 10 10 10 10 10 10 10 17 10 10 10 10 40 44 60 60
60 60 41 43 18 25 20 24 18 67 67 67 66 17 18 19 11 15 15 16 15 10 11 11 16 80 81 10 10 10 15 10 17 10 10 10 10 17 17 17 10 16 19 18 17 15 10 40 44 60 60
60 60 60 60 16 25 21 24 19 60 60 60 65 16 19 19 10 10 10 10 15 16 16 16 16 80 81 17 10 10 15 10 17 10 10 10 10 10 17 10 10 10 10 10 10 10 10 40 44 60 60
60 60 71 63 17 25 20 24 15 63 70 60 65 16 17 18 11 10 10 10 10 10 10 10 17 80 81 17 17 15 10 10 16 17 10 10 10 10 10 10 10 10 10 10 10 10 10 40 44 60 60
60 60 65 10 11 25 20 24 10 10 69 60 65 16 17 19 10 10 11 10 17 10 10 10 16 80 81 17 10 10 10 16 10 10 10 10 10 10 10 10 10 10 10 10 10 10 10 40 44 60 60
60 60 65 10 10 25 21 24 10 10 69 60 65 16 17 19 10 15 11 10 11 10 10 17 16 80 81 10 18 15 10 10 10 10 10 10 17 10 10 10 10 17 17 10 10 10 10 40 44 60 60
60 60 65 10 19 25 21 24 94 10 69 60 65 16 17 17 10 10 16 10 18 11 10 17 16 80 81 17 10 10 10 16 10 10 10 10 10 10 10 17 10 10 10 10 10 10 10 40 44 60 60
60 60 65 10 19 25 20 24 10 10 69 60 65 16 17 16 11 10 17 11 18 10 10 16 16 80 81 10 17 10 10 10 17 10 10 10 10 17 10 10 10 10 10 10 10 10 10 40 44 60 60
60 60 65 10 10 26 22 27 11 10 69 60 65 16 17 15 11 10 10 17 18 18 18 17 15 80 81 10 10 10 10 10 19 10 17 10 17 10 10 10 10 10 10 10 10 10 10 40 44 60 60
60 60 65 10 10 11 10 10 17 10 69 60 65 16 17 15 15 11 10 10 19 19 19 19 15 80 81 10 10 10 10 10 10 10 10 10 10 10 10 10 10 10 10 10 10 10 10 40 44 60 60
60 60 65 10 10 10 11 11 10 10 69 60 73 49 49 49 49 49 49 49 49 49 49 49 49 80 81 49 49 49 49 49 49 49 49 49 49 49 49 49 49 49 49 49 49 49 49 40 44 60 60
60 60 73 67 67 67 67 67 67 67 72 60 60 41 42 42 42 42 42 42 42 42 42 42 42 90 91 42 42 42 42 42 42 42 42 42 42 42 42 42 42 42 42 42 42 42 42 42 43 60 60
60 60 60 60 60 60 60 60 60 60 60 60 60 60 60 60 60 60 60 60 60 60 60 60 60 80 81 60 60 60 60 60 60 60 60 60 60 60 60 60 60 60 60 60 60 60 60 60 60 60 60
60 60 60 60 60 60 60 60 60 60 60 60 60 60 60 60 60 60 60 60 60 60 60 60 60 80 81 60 60 60 60 60 60 60 60 60 60 60 60 60 60 60 60 60 60 60 60 60 60 60 60